  +----------+                                                                 
  |..........|                 +---------+                                     
  |..........####              |.........|                +-------+            
  |..........|                 +-----#---+                |.......#########    
  +----#-----+                       #              #######.......|       #    
       #                             #              #     +---#---+       ###  
       #       +-----------+         #     +--------#+        #             #  
       #########...........##############  |.........|        #                
       #       |...........|            #  |.........|        #                
       #       +-----------+            ####.........|        #                
       #                                   +----#----+        #                
       #                                        #    +--------#--+             
     +-#-------------------------------+        #    |...........|             
     |.................................|        ######...........|             
     |.................................|        #    |...........|             
     |......+---------------+..........|        #    |...........|             
     |......|               |..........##########    +-----------+             
     |......|         ##### |..........|                                       
     |......###           ###..........|                                       
     |......| ######        |..........|                                       
     +------+               +----------+                                       
